## E #############################################
#           #              #                     #
# ######  # # ############ # ############ ########
# #         #          #   # #          #        #
# # ################## # ### # ######## ## #######
# #                  # #   # # #      #          #
# ################## # ### # # # ### #############
#                  # #   # #   #   #             #
#################  # ### # ####### ######## ######
#               # ## #   #       # #             #
# ############# #  # # ######### # # #############
# #                # #     #     # #             #
# ###### ######### # # ### # ##### ############# #
# #                      # #     #             # #
# ##################### ## ###### ############ # #
#       #               #       #            # # #
####### # ######### # ###### ####### ## #### # # #
#       # #                # #               # # #
# ####### # ############## # # ############### # #
# #       # #            # # # #                 #
# ### ##### # ############ # # # ############### #
#   #     #   #          #     # #             # #
### ##### #####    S     ####### ############# # #
#       #     #          #    #              # # #
####### ##### ###### ####### ## ############ # # #
#  #  #  #  # #            #  # #          # # # #
#  #  ##   ## # ########## #  # #########  # # # #
#     #  #  # #            #               # # # #
# ### # ### # # ########## ############### # # # #
# #       # #   #        #               # #   # #
# ####### # ##### ############ #### #### # ### # #
#     #   # #  #           ##  # ## ## # # # ### #
# ##    #         ########               #       #
##################################################