## E ###########################################
#           #            #                     #
# ######  # # ########## # ############ ########
# #         #        #   # #          #        #
# # ################ # ### # ######## ## #######
# #                # #   # # #      #          #
# ################ # ### # # # ### #############
#                # #   # #   #   #             #
###############  # ### # ####### ######## ######
#             # ## #   #       # #             #
# ########### #  # # ######### # # #############
# #              # #     #     # #             #
# ###### ####### # # ### # ##### ############# #
# #                    # #     #             # #
# #################### # ###### ############ # #
#       #              #      #            # # #
####### # ######## # ##### ####### ## #### # # #
#       # #              # #               # # #
# ####### # ############ # # ############### # #
# #       # #          # # # #                 #
# ### ##### # ########## # # # ############### #
#   #     #   #        #    # #              # #
### ##### #########   ####### ############## # #
#       #     #             #              # # #
####### ##### ############ ## ############ # # #
#  #  #  #  # #          #  # #          # # # #
#  #  ##   ## # ######## #  # #########  # # # #
#     #  #  # #          #               # # # #
# ### # ### # # ######## ############### # # # #
# #       # #   #      #               # #   # #
# ####### # ##### ########## #### #### # ##### #
#    ##   # #  ##        ##  # ## ## # #   ### #
# ##    #         ######                 #     #
############################################ S #